
1111111111111111111111111
1000000000000000000000001
10@0300030003000300030001
1000300030003000300030001
1000200020002000200020001
1000300030003000300030001
1000300030003000300030001
1000400040004000400040001
1000300030003000300030001
1000300030003000300030001
1000500050005000500050001
1000300030003000300030001
1000300030003000300030001
1000000000000000000000001
1000200020002000200020001
1000300030003000300030001
1000300030003000300030001
1000400040004000400040001
1000300030003000300030001
1000300030003000300030001
1000500050005000500050001
1000300030003000300030001
1000300030003000300030001
1000000000000000000000001
1111111111111111111111111
